NO ./north.xpm
SO ./south.xpm
WE ./west.xpm
EA ./east.xpm

C 255, 255, 255
F 255, 120, 120

111111111111111111
100000000000000001
100111111111111111   
1001
100111111111111111111   111
100000000000000001001   101
111111111111000111111   111
           10001    
111111111111000111    
10000000111000000111
100000001 1000000101
10000000111000000111
100S000000000000011111
1000000000000000000001         
1111111111111111111111

