NO ./north.xpm
SO ./south.xpm
WE ./west.xpm
EA ./east.xpm

C 173, 216, 230
F 0, 0, 10

11111111111111111111111111
1E000000000000000000001111
11111111111111111000000001
10000000000000000000011111
10000011111111111110011111
100001           10011
10000011111111111110111
10000011111111000000001
11111110000000000000001
11111111111111111111111
