NO ./north.xpm
SO ./south.xpm
WE ./west.xpm
EA ./east.xpm

C 0, 0, 255
F 10, 10, 10

1111111
1N00001
1000001
1000001
1000001
1000001
1111111

