NO ./north.xpm
SO ./south.xpm
WE ./west.xpm
EA ./east.xpm

C 0, 0, 0
F 255, 255, 255

11111111111111111111111111
1W000000000000000000001111
11111111111111111000000001
10000000000000000000011111
10000011111111111110011111
100001           10011
10000011111111111110111
10000011111111000000001
1111111W000000000000001
11111111111111111111111
