NO ./textures/north.xpm
SO ./textures/south.xpm
WE ./textures/west.xpm
EA ./textures/east.xpm

C 255, 215, 10
F 64, 64, 64

   111
   101
11110111111111111111111111
10000000000000000000001
100N0010000000000000011
11111111111001111111111
11111111110011111111111
11111111111000001
100000000000000001111111
10000000000000111111111111
10000000000000001
111111111111111111