NO ./textures/north.xpm
SO ./textures/south.xpm
WE ./textures/west.xpm
EA ./textures/east.xpm

C 0, 0, 10
F 255, 64, 64

   111
   101
11111
1N011
11111