NO ./textures/north.xpm
SO ./textures/south.xpm
WE ./textures/west.xpm
EA ./textures/east.xpm

C 0, 0, 0
F 255, 255, 255

11111111111111111111111111
10000000000000000000000001
10000000000000000000000001
10000000000000000000000001
1000000000000N000000000001
10000000000000000000000001
10000000000000000000000001
11111111111111111111111111