NO ./textures/north.xpm
SO ./textures/south.xpm
WE ./textures/west.xpm
EA ./textures/east.xpm

C 255, 215, 10
F 64, 64, 64

1111111
1000001
100N001
1111111