NO ./textures/north.xpm
SO ./textures/south.xpm
WE ./textures/west.xpm
EA ./textures/east.xpm

C 255, 215, 0
F 64, 64, 64

   111
   101
1111011
1000001
100N001
1111111